seq_idx,locus_name,cell_line,class_idx,locus_center,locus_start,locus_stop,locus_len,dataset,locus_wt
0,LDLR,HepG2,2,1016,857,1174,317,combined,AGCTCTTCACCGGAGACCCAAATACAACAAATCAAGTCGCCTGCCCTGGCGACACTTTCGAAGGACTGGAGTGGGAATCAGAGCTTCACGGGTTAAAAAGCCGATGTCACATCGGCCGTTCGAAACTCCTCCTCTTGCAGTGAGGTGAAGACATTTGAAAATCACCCCACTGCAAACTCCTCCCCCTGCTAGAAACCTCACATTGAAATGCTGTAAATGACGTGGGCCCCGAGTGCAATCGCGGGAAGCCAGGGTTTCCAGCTAGGACACAGCAGGTCGTGATCCGGGTCGGGACACTGCCTGGCAGAGGCTGCGAG
1,ZFAND3,MIN6,NaN,1009,720,1298,578,combined,GTTCATGTTTCCCCCGTATGTGCGTGCGCATGCACATATATAAACACATCTAGCTTCACACCTGTGTACTCACACCTGTGTGTACACACTCCTCCTGTACATGTGTATACACGCACACCCTCCCACCAGCATGAGCAGTATGTGGATTTTTTCTTCCAGCAGCCCTTTCAAGAACATACACCAGATGGGATTGGGTCTGCTACATGACTGAGCAGCCCCCACATCAGAAAGTCATCATCATTGAATCCATCATGTGGTGCAGCCTTGGCAAGGGCACAGCTCCTCGTCCTGCCCAATGGGCCGTGGAGGAATGCCTCCTCCTCCAGAGCAGAGAGCAGATATGGGCAGGCAGTTGCCAGGCAGTTGAGCCGGGAGAACAGATGGCAGCTGCACAGCCTCCTTCTAGCCCAGTTTCCTGGCTGCCGGGGAAGGAGTTGCAGGCGGCAAGGATCCTGCAGAAACCGCCCTCCCTATAACAGGCCATCTTGCCCTCTATCCTCTTACTGGGCTTTGGAGGTCCCAATCCTGCCCTGGTTCACCACCTGTGTGGCTTACCAAGCTGTGCAACTTGGGGCAGG
2,F9,HepG2,2,1031,881,1181,300,combined,GTCCCACTGATGAACTGTGCTGCCACAGTAAATGTAGCCACTATGCCTATCTCCATTCTGAAGATGTGTCACTTCCTGTTTCAGACTCAAATCAGCCACAGTGGCAGAAGCCCACGAAATCAGAGGTGAAATTTAATAATGACCACTGCCCATTCTCTTCACTTGTCCCAAGAGGCCATTGGAAATAGTCCAAAGACCCATTGAGGGAGATGGACATTATTTCCCAGAAGTAAATACAGCTCAGCTTGTACTTTGGTACAACTAATCGACCTTACCACTTTCACAATCTGCTAGCAAAGG
3,SORT1,HepG2,2,1023,724,1322,598,combined,GAACTGGAAAAGCCCTGTCCGGTGAGGGGGCAGAAGGACTCAGCGCCCCTGGACCCCCAAATGCTGCATGAACACATTTTCAGGGGAGCCTGTGCCCCCAGGCGGGGGTCGGGCAGCCCCAGCCCCTCTCCTTTTCCTGGACTCTGGCCGTGCGCGGCAGCCCAGGTGTTTGCTCAGTTGCTGACCCAAAAGTGCTTCATTTTTCGTGCCCGCCCCGCGCCCCGGGCAGGCCAGTCATGTGTTAAGTTGCGCTTCTTTGCTGTGATGTGGGTGGGGGAGGAAGAGTAAACACAGTGCTGGCTCGGCTGCCCTGAGGGTGCTCAATCAAGCACAGGTTTCAAGTCTGGGTTCTGGTGTCCACTCACCCACCCCACCCCCCAAAATCAGACAAATGCTACTTTGTCTAACCTGCTGTGGCCTCTGAGACATGTTCTATTTTTAACCCCTTCTTGGAATTGGCTCTCTTCTTCAAAGGACCAGGTCCTGTTCCTCTTTCTCCCCGACTCCACCCCAGCTCCCTGTGAAGAGAGAGTTAATATATTTGTTTTATTTATTTGCTTTTTGTGTTGGGATGGGTTCGTGTCCAGTCCCGGGGGTC
4,TERT-HEK293T,"HEK293T,SF7996",NaN,1017,888,1146,258,combined,TCGCGGGGGTGGCCGGGGCCAGGGCTTCCCACGTGCGCAGCAGGACGCAGCGCTGCCTGAAACTCGCGCCGCGAGGAGAGGGCGGGGCCGCGGAAAGGAAGGGGAGGGGCTGGGAGGGCCCGGAGGGGGCTGGGCCGGGGACCCGGGAGGGGTCGGGACGGGGCGGGGTCCGCGCGGAGGAGGCGGAGCTGGAAGGTGAAGGGGCAGGACGGGTGCCCGGGTCCCCAGTCCCTCCGCCACGTGGGAAGCGCGGTCCTG
5,MSMB,HEK293T,NaN,1032,737,1327,590,combined,AAAGGTCCAGCAATTCAGCTTGTCAGGGAACCCCGAGCTGTATGTAGTTCTTGCTCTCCTGTGCCCTGCAGGATGGCTTGACCCATTTCTGTTCTCATGTCAGACCCTAAGGGCAGGGTCATCTGGGCCACAGACCCAGGCCCGGTGGGCCTGGTGGGCTGACCTGTGGGCTATTCTTATGCCTTCAGGAAACCCACCTTTACCACCTGGCTGTTGTGACTGGCATCGCTGAGGCTGTTTCTTTGTGTATAAAATCGAATAAGGACACATCACGTGCTAGCAATCCACCAGCATAGGGCGAAGGCTCAGCAAAGAGAAGTTCTCTCCTCCTCTGCTCTTTTAGGTCAGCAGCAAATGCAGATCGGGGTGGGGACAAGGTAAACACATAACTTGGGTGGAGATGTGATTGATTAATAACTCATAAATCATCTGAAACCATACTTTCCTTTTGATAGTCAACCCTCTGTAAACACTCAATGTGTTCTCACCTTGTTATCATTCCCAATGATGTCGAATGCGTGGTTGCCCTCTCCAGTATAAAAGTTTGATGCAGCTTTGCCTGGATGTACCTGTCTATAAGGAGTCCTGCT
6,IRF6,HaCaT,NaN,1021,721,1320,599,combined,AAATGGTGAGTAGGAAGTTGATTCTGCCCGATCTGTCTGACTCCATGCCCTTTCTATTAGGTCATGAAGGGGAACCTGAGGATTGGAGCTTTGGAATGTTAATCTTACCCAAAGGCCTGAAGTAATACCCCAGAATGTGAACATGTGTGACCATCTGCCTGTCCTGGGGGTGGGAAGAAGGCAGCATGCTCTATCCTTGACCCTGATTGAGCCCAGGGGCTGAATCTGGAGCTTTGGGGCCTGGGAACCTCTCTACCTGCGTCAATGTCTGGAGGCCCTGAGAGTTTCGCTCAGGCTCAGAGCAGGCATCGCAACCTCCCAGTTACTATTCTGTGCTGTGGCAAGTGCCAGCTTGTCCTCTCTTCCCCACCCAGCCCGGGAAACCGGCAGCATTTCTAGTTCAGGCCCAGACCCGTCCTGGCAGCCTGGATTCCACTGCCTAGGCAGGAAGCTCATCTCAGCCCAGTGACCTTTTCTCTCTGTTTTTTGTCACAGAGGAATTTCCATGCCAGCAGTATGGGGCAATGGGGGTGGGTGGCCAAAGGTTTCCCCCTTAAGCCACAAGAGCCATGGAGTGGAGGTAAGCTAAGCAAACAGAG
7,TERT-GBM,"HEK293T,SF7996",NaN,1017,888,1146,258,combined,TCGCGGGGGTGGCCGGGGCCAGGGCTTCCCACGTGCGCAGCAGGACGCAGCGCTGCCTGAAACTCGCGCCGCGAGGAGAGGGCGGGGCCGCGGAAAGGAAGGGGAGGGGCTGGGAGGGCCCGGAGGGGGCTGGGCCGGGGACCCGGGAGGGGTCGGGACGGGGCGGGGTCCGCGCGGAGGAGGCGGAGCTGGAAGGTGAAGGGGCAGGACGGGTGCCCGGGTCCCCAGTCCCTCCGCCACGTGGGAAGCGCGGTCCTG
8,IRF4,SK-MEL-28,NaN,1009,784,1234,450,combined,GGCGTGTCCGCCTGTTGGAATATGCTTCTCAGGTCTTCTGGGAAACAGATGTTTTGTGGAAGTGGAAGATTTTGGAAGTAGTGCCTTATCATGTGAAACCACAGGGCAGCTGATCTCTTCAGGCTTTCTTGATGTGAATGACAGCTTTGTTTCATCCACTTTGGTGGGTAAAAGAAGGCAAATTCCCCTGTGGTACTTTTGGTGCCAGGTTTAGCCATATGACGAAGCTTTACATAAAACAGTACAAGTATCTCCATTGTCCTTTATGATCCTCCATGAGTGTTTTCACTTAGTCTGATGAAGGGTTCACTCCAGTCTTTTCGGATGATAAAATGCTTCGGCTGTCAGTCTAATAAGGGATTCCCTGAGGAGTTTGGAGGCTGTAAGAGCACCCCCCGTCTCAATGCCAGTGCTTCTTATCTCAGCCTCTCCTGCACTCCTTTACCCCCG
9,PKLR,K562,5,1023,788,1258,470,combined,TGCTTTCAGTGTGGGCCTGGGGCTGCGGGACCATGGAATGAGAGGGAGAGGATGACAAAACTGCTGGTCTTATCTAAGGGAGACAGAGAAGAGAAAAGGGGCACACCCAGTAGGCCACCCTGTCCCCACAGAATCCCTCCCCCAGAACGGCCTGCTCTCTGCCCTCATCTCCTGGCATTTCCTCTCATCCTTTTTTCCTGATAAATTTTCAATCCATTCATACTATCTGGTCATCCACGTGAATAGATATTTTTTTTTTGGCCAGTCATATGGCCCCATTTTCTTTGTACTTTACTGAAGTTAGCTCTAGTGAATCCAGGGAGCAGGGGCTGTAGGGTGGGGCTGGAGCCTGAAGAAAGACAAAAGGGATCACTGTGATAATATGGTGGGGGGAGGGTTACCCAGTTCTGACCACTTTTTTTCTCTGTCTCAACCAAGAAATGCAGAGTGCCTTCACCACTCTGTAACCT
10,HBB,HEL 92.1.7,NaN,1030,936,1123,187,combined,GGTGTCTGTTTGAGGTTGCTAGTGAACACAGTTGTGTCAGAAGCAAATGTAAGCAATAGATGGCTCTGCCCTGACTTTTATGCCCAGCCCTGGCTCCTGCCCTCCCTGCTCCTGGGAGTAGATTGGCCAACCCTAGGGTGTGGCTCCACAGGGTGAGGTCTAAGTGATGACAGCCGTACCTGTCCTT
11,HBG1,HEL 92.1.7,NaN,1016,879,1153,274,combined,GGCGTCTGGACTAGGAGCTTATTGATAACCTCAGACGTTCCAGAAGCGAGTGTGTGGAACTGCTGAAGGGTGCTTCCTTTTATTCTTCATCCCTAGCCAGCCGCCGGCCCCTGGCCTCACTGGATACTCTAAGACTATTGGTCAAGTTTGCCTTGTCAAGGCTATTGGTCAAGGCAAGGCTGGCCAACCCATGGGTGGAGTTTAGCCAGGGACCGTTTCAGACAGATATTTGCATTGAGATAGTGTGGGGAAGGGGCCCCCAAGAGGATACTGC
12,HNF4A,HEK293T,NaN,1031,889,1173,284,combined,CCCCAGAGTGCAGGACTAGGACCCGAGTGGACCTCAGGTCTGGCCAGGTCGCCATTGCCATGGAGACAGCAACAGTCCCCAGCCGCGGGTTCCCTAAGTGACTGGTTACTCTTTAACGTATCCACCCACCTTGGGTGATTAGAAGAATCAATAAGATAACCGGGCGGTGGCAGCTGGCCGCACTCACCGCCTTCCTGGTGGACGGGCTCCTGGTGGCTGTGCTGCTGCTGTGAGCGGGCCCCTGCTCCTCCATGCCCCCAGCTCTCCGGCTGGGTGGGCTTGGC
13,MYCrs6983267,HEK293T,NaN,1016,716,1315,599,combined,CTGCATCGCTCCATAGAGCCTGCAGAGGGCACTAGACTGGGAATTAGAAAACCTGATTTCCCTTCCAGCTCCACCTCTGACCAATTGCCTGACCCTGGTCAAATTGCTTAACCTCTTCCTATCTCAGCTCCCTATCCATAAAACAGAGGGACGAATAAACTCTCCTCCTACCACTAAGAGGTGTAGCCAGAGTTAATACCCTCATCGTCCTTTGAGCTCAGCAGATGAAAGGCACTGAGAAAAGTACAAAGAATTTTTATGTGCTATTGACTTTATTTTATTTTATGTGGGGGAGGGAGCCGGCCCCAGCTGGAAAGCTGCTTTCTCTGAATCAAAGGGCAGGAACCCAGCAAGTTTCTCAGGATTGGGGCCTTAGACTGGGCTGTGTATACAGACAGTGCCAGCCAACCCCACAGTTCAGTTTCCTTTAACCTGGTGCTCCAGGCAATAACTGTGCAACTCTGCAATTTAACAATGTGTTCTTTGTCCCACAACTGTTCTCGTTTCTCAACTGCCCAGGTAATATGTTTGGGCCTGTAGGAAGAGTCAAATAGTTAATAAGGGAAGGGTTTGGCATGCCCTACGTAAGTTCTACCAGC
14,GP1BB,HEL 92.1.7,NaN,1007,815,1199,384,combined,CGTTGTGAATGCCGCGTCCTGTCCTGGTGACAGGAGAACAATGTTGGTGAACGTCGCAGCGGGTGTCCGAGTGCTCCGTGTGCCCCTGAGAGCGGGTGGGAGCGGAAGCCTGAGCGGCCTGCGGCCTCCGGCGATAGTGTGCTATCTGCCGCTGCAGCGCGCGTCCGCGCGGCCTCTGGGCTATTTCTGGCCAGGCCGCAGCACTGTGGTCGGTGCGGGCGTGGCAGGGGCGGGGCGGCCTTATCGCTCGGCTCTCCCGCCTACGCCTCCCGCTGCAGAGTAAGCCGGGCTGCCGTCTTCTCGCCATGGGCTCCGGTGAGTCTGGAGTCCGGTCGGGCCCCCGGCTGCTCCCTAGGCCGACCCGGGTTGAGAGGAGCTCTGGTC