seq_idx,locus_name,cell_line,class_idx,locus_center,locus_start,locus_stop,locus_len,dataset,locus_wt
0,LDLR,HepG2,HepG2,196600,196441,196758,317,combined,AGCTCTTCACCGGAGACCCAAATACAACAAATCAAGTCGCCTGCCCTGGCGACACTTTCGAAGGACTGGAGTGGGAATCAGAGCTTCACGGGTTAAAAAGCCGATGTCACATCGGCCGTTCGAAACTCCTCCTCTTGCAGTGAGGTGAAGACATTTGAAAATCACCCCACTGCAAACTCCTCCCCCTGCTAGAAACCTCACATTGAAATGCTGTAAATGACGTGGGCCCCGAGTGCAATCGCGGGAAGCCAGGGTTTCCAGCTAGGACACAGCAGGTCGTGATCCGGGTCGGGACACTGCCTGGCAGAGGCTGCGAG
1,ZFAND3,MIN6,pancreas,196593,196304,196882,578,combined,GTTCATGTTTCCCCCGTATGTGCGTGCGCATGCACATATATAAACACATCTAGCTTCACACCTGTGTACTCACACCTGTGTGTACACACTCCTCCTGTACATGTGTATACACGCACACCCTCCCACCAGCATGAGCAGTATGTGGATTTTTTCTTCCAGCAGCCCTTTCAAGAACATACACCAGATGGGATTGGGTCTGCTACATGACTGAGCAGCCCCCACATCAGAAAGTCATCATCATTGAATCCATCATGTGGTGCAGCCTTGGCAAGGGCACAGCTCCTCGTCCTGCCCAATGGGCCGTGGAGGAATGCCTCCTCCTCCAGAGCAGAGAGCAGATATGGGCAGGCAGTTGCCAGGCAGTTGAGCCGGGAGAACAGATGGCAGCTGCACAGCCTCCTTCTAGCCCAGTTTCCTGGCTGCCGGGGAAGGAGTTGCAGGCGGCAAGGATCCTGCAGAAACCGCCCTCCCTATAACAGGCCATCTTGCCCTCTATCCTCTTACTGGGCTTTGGAGGTCCCAATCCTGCCCTGGTTCACCACCTGTGTGGCTTACCAAGCTGTGCAACTTGGGGCAGG
2,F9,HepG2,HepG2,196615,196465,196765,300,combined,GTCCCACTGATGAACTGTGCTGCCACAGTAAATGTAGCCACTATGCCTATCTCCATTCTGAAGATGTGTCACTTCCTGTTTCAGACTCAAATCAGCCACAGTGGCAGAAGCCCACGAAATCAGAGGTGAAATTTAATAATGACCACTGCCCATTCTCTTCACTTGTCCCAAGAGGCCATTGGAAATAGTCCAAAGACCCATTGAGGGAGATGGACATTATTTCCCAGAAGTAAATACAGCTCAGCTTGTACTTTGGTACAACTAATCGACCTTACCACTTTCACAATCTGCTAGCAAAGG
3,SORT1,HepG2,HepG2,196607,196308,196906,598,combined,GAACTGGAAAAGCCCTGTCCGGTGAGGGGGCAGAAGGACTCAGCGCCCCTGGACCCCCAAATGCTGCATGAACACATTTTCAGGGGAGCCTGTGCCCCCAGGCGGGGGTCGGGCAGCCCCAGCCCCTCTCCTTTTCCTGGACTCTGGCCGTGCGCGGCAGCCCAGGTGTTTGCTCAGTTGCTGACCCAAAAGTGCTTCATTTTTCGTGCCCGCCCCGCGCCCCGGGCAGGCCAGTCATGTGTTAAGTTGCGCTTCTTTGCTGTGATGTGGGTGGGGGAGGAAGAGTAAACACAGTGCTGGCTCGGCTGCCCTGAGGGTGCTCAATCAAGCACAGGTTTCAAGTCTGGGTTCTGGTGTCCACTCACCCACCCCACCCCCCAAAATCAGACAAATGCTACTTTGTCTAACCTGCTGTGGCCTCTGAGACATGTTCTATTTTTAACCCCTTCTTGGAATTGGCTCTCTTCTTCAAAGGACCAGGTCCTGTTCCTCTTTCTCCCCGACTCCACCCCAGCTCCCTGTGAAGAGAGAGTTAATATATTTGTTTTATTTATTTGCTTTTTGTGTTGGGATGGGTTCGTGTCCAGTCCCGGGGGTC
4,TERT-HEK293T,"HEK293T,SF7996",HEK293,196601,196472,196730,258,combined,TCGCGGGGGTGGCCGGGGCCAGGGCTTCCCACGTGCGCAGCAGGACGCAGCGCTGCCTGAAACTCGCGCCGCGAGGAGAGGGCGGGGCCGCGGAAAGGAAGGGGAGGGGCTGGGAGGGCCCGGAGGGGGCTGGGCCGGGGACCCGGGAGGGGTCGGGACGGGGCGGGGTCCGCGCGGAGGAGGCGGAGCTGGAAGGTGAAGGGGCAGGACGGGTGCCCGGGTCCCCAGTCCCTCCGCCACGTGGGAAGCGCGGTCCTG
5,MSMB,HEK293T,HEK293,196616,196321,196911,590,combined,AAAGGTCCAGCAATTCAGCTTGTCAGGGAACCCCGAGCTGTATGTAGTTCTTGCTCTCCTGTGCCCTGCAGGATGGCTTGACCCATTTCTGTTCTCATGTCAGACCCTAAGGGCAGGGTCATCTGGGCCACAGACCCAGGCCCGGTGGGCCTGGTGGGCTGACCTGTGGGCTATTCTTATGCCTTCAGGAAACCCACCTTTACCACCTGGCTGTTGTGACTGGCATCGCTGAGGCTGTTTCTTTGTGTATAAAATCGAATAAGGACACATCACGTGCTAGCAATCCACCAGCATAGGGCGAAGGCTCAGCAAAGAGAAGTTCTCTCCTCCTCTGCTCTTTTAGGTCAGCAGCAAATGCAGATCGGGGTGGGGACAAGGTAAACACATAACTTGGGTGGAGATGTGATTGATTAATAACTCATAAATCATCTGAAACCATACTTTCCTTTTGATAGTCAACCCTCTGTAAACACTCAATGTGTTCTCACCTTGTTATCATTCCCAATGATGTCGAATGCGTGGTTGCCCTCTCCAGTATAAAAGTTTGATGCAGCTTTGCCTGGATGTACCTGTCTATAAGGAGTCCTGCT
6,IRF6,HaCaT,keratinocyte,196605,196305,196904,599,combined,AAATGGTGAGTAGGAAGTTGATTCTGCCCGATCTGTCTGACTCCATGCCCTTTCTATTAGGTCATGAAGGGGAACCTGAGGATTGGAGCTTTGGAATGTTAATCTTACCCAAAGGCCTGAAGTAATACCCCAGAATGTGAACATGTGTGACCATCTGCCTGTCCTGGGGGTGGGAAGAAGGCAGCATGCTCTATCCTTGACCCTGATTGAGCCCAGGGGCTGAATCTGGAGCTTTGGGGCCTGGGAACCTCTCTACCTGCGTCAATGTCTGGAGGCCCTGAGAGTTTCGCTCAGGCTCAGAGCAGGCATCGCAACCTCCCAGTTACTATTCTGTGCTGTGGCAAGTGCCAGCTTGTCCTCTCTTCCCCACCCAGCCCGGGAAACCGGCAGCATTTCTAGTTCAGGCCCAGACCCGTCCTGGCAGCCTGGATTCCACTGCCTAGGCAGGAAGCTCATCTCAGCCCAGTGACCTTTTCTCTCTGTTTTTTGTCACAGAGGAATTTCCATGCCAGCAGTATGGGGCAATGGGGGTGGGTGGCCAAAGGTTTCCCCCTTAAGCCACAAGAGCCATGGAGTGGAGGTAAGCTAAGCAAACAGAG
7,TERT-GBM,"HEK293T,SF7996",glioblastoma,196601,196472,196730,258,combined,TCGCGGGGGTGGCCGGGGCCAGGGCTTCCCACGTGCGCAGCAGGACGCAGCGCTGCCTGAAACTCGCGCCGCGAGGAGAGGGCGGGGCCGCGGAAAGGAAGGGGAGGGGCTGGGAGGGCCCGGAGGGGGCTGGGCCGGGGACCCGGGAGGGGTCGGGACGGGGCGGGGTCCGCGCGGAGGAGGCGGAGCTGGAAGGTGAAGGGGCAGGACGGGTGCCCGGGTCCCCAGTCCCTCCGCCACGTGGGAAGCGCGGTCCTG
8,IRF4,SK-MEL-28,SK-MEL,196593,196368,196818,450,combined,GGCGTGTCCGCCTGTTGGAATATGCTTCTCAGGTCTTCTGGGAAACAGATGTTTTGTGGAAGTGGAAGATTTTGGAAGTAGTGCCTTATCATGTGAAACCACAGGGCAGCTGATCTCTTCAGGCTTTCTTGATGTGAATGACAGCTTTGTTTCATCCACTTTGGTGGGTAAAAGAAGGCAAATTCCCCTGTGGTACTTTTGGTGCCAGGTTTAGCCATATGACGAAGCTTTACATAAAACAGTACAAGTATCTCCATTGTCCTTTATGATCCTCCATGAGTGTTTTCACTTAGTCTGATGAAGGGTTCACTCCAGTCTTTTCGGATGATAAAATGCTTCGGCTGTCAGTCTAATAAGGGATTCCCTGAGGAGTTTGGAGGCTGTAAGAGCACCCCCCGTCTCAATGCCAGTGCTTCTTATCTCAGCCTCTCCTGCACTCCTTTACCCCCG
9,PKLR,K562,K562,196607,196372,196842,470,combined,TGCTTTCAGTGTGGGCCTGGGGCTGCGGGACCATGGAATGAGAGGGAGAGGATGACAAAACTGCTGGTCTTATCTAAGGGAGACAGAGAAGAGAAAAGGGGCACACCCAGTAGGCCACCCTGTCCCCACAGAATCCCTCCCCCAGAACGGCCTGCTCTCTGCCCTCATCTCCTGGCATTTCCTCTCATCCTTTTTTCCTGATAAATTTTCAATCCATTCATACTATCTGGTCATCCACGTGAATAGATATTTTTTTTTTGGCCAGTCATATGGCCCCATTTTCTTTGTACTTTACTGAAGTTAGCTCTAGTGAATCCAGGGAGCAGGGGCTGTAGGGTGGGGCTGGAGCCTGAAGAAAGACAAAAGGGATCACTGTGATAATATGGTGGGGGGAGGGTTACCCAGTTCTGACCACTTTTTTTCTCTGTCTCAACCAAGAAATGCAGAGTGCCTTCACCACTCTGTAACCT
10,HBB,HEL 92.1.7,K562,196614,196520,196707,187,combined,GGTGTCTGTTTGAGGTTGCTAGTGAACACAGTTGTGTCAGAAGCAAATGTAAGCAATAGATGGCTCTGCCCTGACTTTTATGCCCAGCCCTGGCTCCTGCCCTCCCTGCTCCTGGGAGTAGATTGGCCAACCCTAGGGTGTGGCTCCACAGGGTGAGGTCTAAGTGATGACAGCCGTACCTGTCCTT
11,HBG1,HEL 92.1.7,K562,196600,196463,196737,274,combined,GGCGTCTGGACTAGGAGCTTATTGATAACCTCAGACGTTCCAGAAGCGAGTGTGTGGAACTGCTGAAGGGTGCTTCCTTTTATTCTTCATCCCTAGCCAGCCGCCGGCCCCTGGCCTCACTGGATACTCTAAGACTATTGGTCAAGTTTGCCTTGTCAAGGCTATTGGTCAAGGCAAGGCTGGCCAACCCATGGGTGGAGTTTAGCCAGGGACCGTTTCAGACAGATATTTGCATTGAGATAGTGTGGGGAAGGGGCCCCCAAGAGGATACTGC
12,HNF4A,HEK293T,HEK293,196615,196473,196757,284,combined,CCCCAGAGTGCAGGACTAGGACCCGAGTGGACCTCAGGTCTGGCCAGGTCGCCATTGCCATGGAGACAGCAACAGTCCCCAGCCGCGGGTTCCCTAAGTGACTGGTTACTCTTTAACGTATCCACCCACCTTGGGTGATTAGAAGAATCAATAAGATAACCGGGCGGTGGCAGCTGGCCGCACTCACCGCCTTCCTGGTGGACGGGCTCCTGGTGGCTGTGCTGCTGCTGTGAGCGGGCCCCTGCTCCTCCATGCCCCCAGCTCTCCGGCTGGGTGGGCTTGGC
13,MYCrs6983267,HEK293T,HEK293,196600,196300,196899,599,combined,CTGCATCGCTCCATAGAGCCTGCAGAGGGCACTAGACTGGGAATTAGAAAACCTGATTTCCCTTCCAGCTCCACCTCTGACCAATTGCCTGACCCTGGTCAAATTGCTTAACCTCTTCCTATCTCAGCTCCCTATCCATAAAACAGAGGGACGAATAAACTCTCCTCCTACCACTAAGAGGTGTAGCCAGAGTTAATACCCTCATCGTCCTTTGAGCTCAGCAGATGAAAGGCACTGAGAAAAGTACAAAGAATTTTTATGTGCTATTGACTTTATTTTATTTTATGTGGGGGAGGGAGCCGGCCCCAGCTGGAAAGCTGCTTTCTCTGAATCAAAGGGCAGGAACCCAGCAAGTTTCTCAGGATTGGGGCCTTAGACTGGGCTGTGTATACAGACAGTGCCAGCCAACCCCACAGTTCAGTTTCCTTTAACCTGGTGCTCCAGGCAATAACTGTGCAACTCTGCAATTTAACAATGTGTTCTTTGTCCCACAACTGTTCTCGTTTCTCAACTGCCCAGGTAATATGTTTGGGCCTGTAGGAAGAGTCAAATAGTTAATAAGGGAAGGGTTTGGCATGCCCTACGTAAGTTCTACCAGC
14,GP1BB,HEL 92.1.7,K562,196591,196399,196783,384,combined,CGTTGTGAATGCCGCGTCCTGTCCTGGTGACAGGAGAACAATGTTGGTGAACGTCGCAGCGGGTGTCCGAGTGCTCCGTGTGCCCCTGAGAGCGGGTGGGAGCGGAAGCCTGAGCGGCCTGCGGCCTCCGGCGATAGTGTGCTATCTGCCGCTGCAGCGCGCGTCCGCGCGGCCTCTGGGCTATTTCTGGCCAGGCCGCAGCACTGTGGTCGGTGCGGGCGTGGCAGGGGCGGGGCGGCCTTATCGCTCGGCTCTCCCGCCTACGCCTCCCGCTGCAGAGTAAGCCGGGCTGCCGTCTTCTCGCCATGGGCTCCGGTGAGTCTGGAGTCCGGTCGGGCCCCCGGCTGCTCCCTAGGCCGACCCGGGTTGAGAGGAGCTCTGGTC
